8 8
00000000
0**00**0
0**00**0
000**000
00****00
00****00
00*00*00
00000000